21 24
# # # # # # # # # # # # # # # # # # # # # # # # 
# . . . . . . . . . . # . . . # . . . . . . . # 
# S # . # . # # . # . . . # . . . . # # # . . # 
# # # . # . # . . # . # . # . # . . # . . . . # 
# . # . . . # # . # . # . # # # # . # # # . . # 
# . # # . # . # . # . # . # . . # . . . . . . # 
# . . # . # . # . # . # . # # . # # # # # # # # 
# # . # . # . . . . . # . . . . . . . . . . . # 
# . . . . # . . . # . # # # # . # . # # # . . # 
# . . . . # . . . # . . . . . . # . . . . . . # 
# # # # # # # # # # # # # # # # # . # # # # # # 
# . . . . . . . . . . # . . . # . . . . . . . # 
# E # . # . # # . # . . . # . . . . # # # . . # 
# # # . # . # . . # . # . # . # . . # . . . . # 
# . # . . . # # . # . # . # # # # . # # # . . # 
# . # # . # . # . # . # . # E . # . . . . . . # 
# . . # . # . # . # . # . # # . # # # # # # # # 
# # . # . # . . . . . # . . . . . . . . . . . # 
# E . . . # . . . # . # # # # . # . # # # . . # 
# . . . . # . . . # . . . . . . # . . . E . . # 
# # # # # # # # # # # # # # # # # # # # # # # # 